88
01100110
11111111
11111111
10011111
00011110
00111100
00011000
5
5
6
a
a
7
7
3
9