77
1111110
1111101
1111011
1110111
1101111
1011111
0111111
3
3
5
6
k
g
f
8
h
i